A B A A A A A A A A A A
A C A D D E A C C C D A
A C C D A E A D A D A A
A A A A A E D D A D E A
A C C D D D A A A A E A
A C A A A A A D D D E A
A D D D E E A C A A A A
A A A E A E A C C D D A
A D E E A D A A A A A A
A A D A A D A C D D A A
A D D D A D C C A D E B
A A A A A A A A A A A A